быть	be [би]	 was/were [воз/вё]	 been [бин]									
бить	beat [бит]	 beat [бит]	 beaten [битн]									
становится	become [бикам]	 became [бикейм]	 become [бикам]									
начинать	begin [бигин]	 began [бигэн]	 begun [биган]									
сгибать	bend [бенд]	 bent [бент]	 bent [бент]									
ставить	bet [бет]	 bet [бет]	 bet [бет]									
кусать	bite [байт]	 bit [бит]	 bitten [битн]									
дуть	blow [блоу]	 blew [блю]	 blown [блоун]									
ломать	break [брейк]	 broke [броук]	 broken [броукн]									
приносить	bring [бринг]	 brought [брот]	 brought [брот]									
транслировать	broadcast [бродкаст]	 broadcast [бродкаст]	 broadcast [бродкаст]									
строить	build [билд]	 built [билт]	 built [билт]									
лопаться	burst [бёрст]	 burst [бёрст]	 burst [бёрст]									
покупать	buy [бай]	 bought [бот]	 bought [бот]									
ловить	catch [кэтч]	 caught [кот]	 caught [кот]									
выбирать	choose [чуз]	 chose [чоуз]	 chosen [чоузн]									
приходить	come [кам]	 came [кейм]	 come [кам]									
стоить	cost [кост]	 cost [кост]	 cost [кост]									
ползать	creep [крип]	 crept [крепт]	 crept [крепт]									
резать	cut [кат]	 cut [кат]	 cut [кат]									
иметь дело	deal [дил]	 dealt [дэлт]	 dealt [дэлт]									
копать	dig [диг]	 dug [даг]	 dug [даг]									
делать	do [ду]	 did [дид]	 done [дан]									
рисовать	draw [дро]	 drew [дру]	 drawn [дрон]									
пить	drink [дринк]	 drank [дрэнк]	 drunk [друнк]									
водить	drive [драйв]	 drove [дроув]	 driven [дривн]									
есть	eat [ит]	 ate [эйт]	 eaten [итн]									
падать	fall [фол]	 fell [фэл]	 fallen [фолэн]									
кормить	feed [фид]	 fed [фед]	 fed [фед]									
чувствовать	feel [фил]	 felt [фэлт]	 felt [фэлт]									
сражаться	fight [файт]	 fought [фот]	 fought [фот]									
находить	find [файнд]	 found [фаунд]	 found [фаунд]									
убегать	flee [фли]	 fled [флед]	 fled [флед]									
летать	fly [флай]	 flew [флю]	 flown [флоун]									
запретить	forbid [форбид]	 forbade [форбейд]	 forbidden [форбидн]									
забыть	forget [форгет]	 forgot [форгот]	 forgotten [форготн]									
простить	forgive [форгив]	 forgave [форгейв]	 forgiven [форгивн]									
замерзать	freeze [фриз]	 froze [фроуз]	 frozen [фрозн]									
получать	get [гет]	 got [гот]	 got/gotten [гот/готн]									
давать	give [гив]	 gave [гейв]	 given [гивн]									
идти	go [гоу]	 went [вент]	 gone [гон]									
рости	grow [гроу]	 grew [грю]	 grown [гроун]									
висеть	hang [хэнг]	 hung [ханг]	 hung [ханг]									
иметь	have [хэв]	 had [хэд]	 had [хэд]									
слышать	hear [хир]	 heard [хёрд]	 heard [хёрд]									
прятать	hide [хайд]	 hid [хид]	 hidden [хидн]									
ударять	hit [хит]	 hit [хит]	 hit [хит]									
держать	hold [хоулд]	 held [хэлд]	 held [хэлд]									
ранить	hurt [хёрт]	 hurt [хёрт]	 hurt [хёрт]									
сдерживать	keep [кип]	 kept [кепт]	 kept [кепт]									
становится на колени	kneel [нил]	 knelt [нэлт]	 knelt [нэлт]									
знать	know [ноу]	 knew [нью]	 known [ноун]									
выкладывать	lay [лэй]	 laid [лэйд]	 laid [лэйд]									
руководить	lead [лид]	 led [лед]	 led [лед]									
оставлять	leave [лив]	 left [лефт]	 left [лефт]									
одалживать	lend [ленд]	 lent [лент]	 lent [лент]									
позволять	let [лет]	 let [лет]	 let [лет]									
лежать	lie [лай]	 lay [лэй]	 lain [лэйн]									
светить	light [лайт]	 lit [лит]	 lit [лит]									
проигрывать	lose [луз]	 lost [лост]	 lost [лост]									
создавать	make [мейк]	 made [мейд]	 made [мейд]									
значить	mean [мин]	 meant [мент]	 meant [мент]									
встречаться	meet [мит]	 met [мет]	 met [мет]									
платить	pay [пэй]	 paid [пейд]	 paid [пейд]									
положить	put [пут]	 put [пут]	 put [пут]									
читать	read [рид]	 read [ред]	 read [ред]									
ездить верхом	ride [райд]	 rode [роуд]	 ridden [ридн]									
звонить	ring [ринг]	 rang [рэнг]	 rung [ранг]									
возрастать	rise [райз]	 rose [роуз]	 risen [райзн]									
бежать	run [ран]	 ran [рэн]	 run [ран]									
сказать	say [сэй]	 said [сед]	 said [сед]									
видеть	see [си]	 saw [со]	 seen [син]									
искать	seek [сик]	 sought [сот]	 sought [сот]									
продавать	sell [сел]	 sold [соулд]	 sold [соулд]									
слать	send [сенд]	 sent [сент]	 sent [сент]									
устанавливать	set [сет]	 set [сет]	 set [сет]									
шить	sew [соу]	 sewed [соуд]	 sewn/sewed [соун/соуд]									
трясти	shake [шейк]	 shook [шук]	 shaken [шейкн]									
сиять	shine [шайн]	 shone [шон]	 shone [шон]									
стрелять	shoot [шут]	 shut [шат]	 shut [шат]									
показывать	show [шоу]	 showed [шоуд]	 shown/showed [шоун/шоуд]									
сокращать	shrink [шринк]	 shrank [шрэнк]	 shrunk [шранк]									
закрыть	shut [шат]	 shut [шат]	 shut [шат]									
петь	sing [синг]	 sang [сэнг]	 sung [санг]									
тонуть	sink [синк]	 sank [сэнк]	 sunk [санк]									
сидеть	sit [сит]	 sat [сэт]	 sat [сэт]									
спать	sleep [слип]	 slept [слепт]	 slept [слепт]									
скользить	slide [слайд]	 slid [след]	 slid [след]									
говорить	speak [спик]	 spoke [споук]	 spoken [споукн]									
тратить	spend [спенд]	 spent [спент]	 spent [спент]									
плевать	spit [спит]	 spat [спэт]	 spat [спэт]									
разделять	split [сплит]	 split [сплит]	 split [сплит]									
распросранять	spread [спред]	 spread [спред]	 spread [спред]									
возникать	spring [спринг]	 sprang [спрэнг]	 sprung [спранг]									
стоять	stand [стэнд]	 stood [студ]	 stood [студ]									
красть	steal [стил]	 stole [стоул]	 stolen [стоулн]									
застревать	stick [стик]	 stuck [стак]	 stuck [стак]									
жалить	sting [стинг]	 stung [станг]	 stung [станг]									
вонять	stink [стинк]	 stank [стэнк]	 stunk [станк]									
колотить	strike [страйк]	 struck [страк]	 struck [страк]									
клясться	swear [свэр]	 swore [свор]	 sworn [сворн]									
мести	sweep [свип]	 swept [свепт]	 swept [свепт]									
плавать	swim [свим]	 swam [свэм]	 swum [свам]									
качать	swing [свинг]	 swung [сванг]	 swung [сванг]									
брать	take [тейк]	 took [тук]	 taken [тейкн]									
учить	teach [тич]	 tought [тоут]	 tought [тоут]									
рвать	tear [тир]	 tore [тор]	 torn [торн]									
рассказывать	tell [тел]	 told [толд]	 told [толд]									
думать	think [тинк]	 thought [тот]	 thought [тот]									
бросать	throw [троу]	 threw [тру]	 thrown [троун]									
понимать	understand [андэрстэнд]	 understood [андэрстуд]	 understood [андэрстуд]									
будить	wake [вейк]	 woke [воук]	 woken [воукн]									
носить	wear [вир]	 wore [вор]	 worn [ворн]									
плакать	weep [вип]	 wept [вепт]	 wept [вепт]									
выигрывать	win [вин]	 won [вон]	 won [вон]									
писать	write [райт]	 wrote [роут]	 written [ритн]									
